{
	"dimensions": {
		"rowLen": 5,
		"height": 6,
		"numRowsPerHeight": 5
	},
	"start": [
				4,4,4,4,4,
				4,4,4,4,4,
				4,4,4,4,4,
				4,4,4,4,4,
				4,4,4,4,4,
				
				1,1,1,1,1,
				1,1,1,1,1,
				1,1,1,1,1,
				1,1,1,1,1,
				1,1,1,1,1,
				
				1,1,1,1,1,
				1,1,1,1,1,
				1,1,1,1,1,
				1,1,1,1,1,
				1,1,1,1,1,

				1,1,1,1,1,
				1,1,1,1,1,
				1,1,1,1,1,
				1,1,1,1,1,
				1,1,1,1,1,
				
				0,0,0,0,0,
				0,0,0,0,0,
				0,0,0,0,0,
				0,0,0,0,0,
				0,0,0,0,0,
				
				0,0,0,0,0,
				0,0,0,0,0,
				0,0,0,0,0,
				0,0,0,0,0,
				0,0,0,0,0
			],
	"goal": [
				4,4,4,4,4,
				4,4,4,4,4,
				4,4,4,4,4,
				4,4,4,4,4,
				4,4,4,4,4,
				
				1,1,1,1,1,
				1,1,1,1,1,
				1,1,1,1,1,
				1,1,1,1,1,
				1,1,1,1,1,
				
				1,1,1,1,1,
				1,1,1,1,1,
				1,1,1,1,1,
				1,1,1,1,1,
				1,1,1,1,1,

				1,1,1,1,1,
				1,0,1,1,1,
				1,0,1,1,1,
				1,0,1,1,1,
				1,1,1,1,1,
				
				0,0,0,0,0,
				0,0,0,1,0,
				0,0,0,1,0,
				0,0,0,0,0,
				0,0,0,0,0,
				
				0,0,0,0,0,
				0,0,0,1,0,
				0,0,0,1,0,
				0,0,0,0,0,
				0,0,0,0,0
			]
}