{
	"dimensions": {
		"rowLen": 5,
		"height": 6,
		"numRowsPerHeight": 5
	},
	"elements": {
		"earth": true,
		"water": true,
		"fire": true,
		"wind": true
	},
	"start": [
				4,4,4,4,4,
				4,4,4,4,4,
				4,4,4,4,4,
				4,4,4,4,4,
				4,4,4,4,4,
				
				1,1,1,1,1,
				1,1,1,1,1,
				1,1,1,1,1,
				1,1,1,1,1,
				1,1,1,1,1,
				
				1,1,1,1,1,
				1,1,1,1,1,
				1,1,1,1,1,
				1,1,1,1,1,
				1,1,1,1,1,

				1,1,1,1,1,
				1,1,1,1,1,
				1,1,1,1,1,
				1,1,1,1,1,
				1,1,1,1,1,
				
				0,0,0,0,0,
				0,0,0,0,0,
				0,0,0,0,0,
				0,0,0,0,0,
				0,0,0,0,0,
				
				0,0,0,0,0,
				0,0,0,0,0,
				0,0,0,0,0,
				0,0,0,0,0,
				0,0,0,0,0
			],
	"goal": [
				4,4,4,4,4,
				4,4,4,4,4,
				4,4,4,4,4,
				4,4,4,4,4,
				4,4,4,4,4,
				
				1,1,1,1,1,
				1,1,1,1,1,
				1,1,1,1,1,
				1,1,1,1,1,
				1,1,1,1,1,
				
				1,1,1,1,1,
				1,1,1,1,1,
				1,1,1,1,1,
				1,1,1,1,1,
				1,1,1,1,1,

				1,3,3,3,1,
				3,1,3,1,3,
				3,3,2,3,3,
				3,1,3,1,3,
				1,3,3,3,1,
				
				0,0,0,0,0,
				0,0,0,0,0,
				0,0,0,0,0,
				0,0,0,0,0,
				0,0,0,0,0,
				
				0,0,0,0,0,
				0,0,0,0,0,
				0,0,0,0,0,
				0,0,0,0,0,
				0,0,0,0,0
			]
}