{
	"dimensions": {
		"rowLen": 5,
		"height": 6,
		"numRowsPerHeight": 5
	},
	"elements": {
		"earth": true,
		"water": true,
		"fire": true,
		"wind": false
	},
	"start": [
				4,4,4,4,4,
				4,4,4,4,4,
				4,4,4,4,4,
				4,4,4,4,4,
				4,4,4,4,4,
				
				1,1,1,1,1,
				1,1,1,1,1,
				1,1,1,1,1,
				1,1,1,1,1,
				1,1,1,1,1,
				
				1,1,1,1,1,
				1,1,1,1,1,
				1,1,1,1,1,
				1,1,1,1,1,
				1,1,1,1,1,
				
				2,2,2,2,2,
				2,1,1,1,2,
				2,1,1,1,2,
				2,1,1,1,2,
				2,2,2,2,2,
				
				2,2,2,2,2,
				2,2,2,2,2,
				2,2,2,2,2,
				2,2,2,2,2,
				2,2,2,2,2,
				
				0,0,0,0,0,
				0,0,0,0,0,
				0,0,0,0,0,
				0,0,0,0,0,
				0,0,0,0,0
			],
	"goal": [
				4,4,4,4,4,
				4,4,4,4,4,
				4,4,4,4,4,
				4,4,4,4,4,
				4,4,4,4,4,
				
				1,1,1,1,1,
				1,1,1,1,1,
				1,1,1,1,1,
				1,1,1,1,1,
				1,1,1,1,1,
				
				1,1,1,1,1,
				1,1,1,1,1,
				1,1,1,1,1,
				1,1,1,1,1,
				1,1,1,1,1,
				
				0,0,0,0,0,
				0,1,1,1,0,
				0,1,1,1,0,
				0,1,1,1,0,
				0,0,0,0,0,
				
				0,0,0,0,0,
				0,0,0,0,0,
				0,0,0,0,0,
				0,0,0,0,0,
				0,0,0,0,0,
				
				0,0,0,0,0,
				0,0,0,0,0,
				0,0,0,0,0,
				0,0,0,0,0,
				0,0,0,0,0
			]
}